SSWWWDRDFFFFFFFFFFFFFFFFFFFFFFFFFFFFFFFFFFFFFFFFFF
SSSWWWDRDFFFFFFFFFFFFFFFFFFFFFFFFFFFFFFFFFFFFFFFFF
SSSWWWDRDFFFFFFFFFFFFFFFFFFFFFFFFFFFFFFFFFFFFFFFFF
SSSSWWDRRDFFFFFFFFFFFFFFFFFFFFFFFFFFFFFFFFFFFFFFFF
SSSSSWWDRDFFFFFFFFFFFFFFFFFFFFFFFFFFFFFFFFFFFFFFFF
SSSSSWWDRDFFFFFFFFFFFFFFFFFFFFFFFFFFFFFFFFFFFFFFFF
SSSSSWWDRDFFFFFFFFFFFFFFFFFFFFFFFFFFFFFFFFFFFFFFFF
SSSSSSWWDRDDDFFFFFFFFFFFFFFFFFFFFFFFFFFFFFFFFFFFFF
DSSSSSWWDRDDDDDFFFFFFFFFFFFFFFFFFFFFFFFFFFFFFFFFFF
DDDSSSWWDDRRDDDDDDFFFFFFFFFFFFFFFFFFFFFFFFFFFFFFFF
FFDDDSSWWDCCRCCCCDDFFFFFFFFFFFFFFFFFFFFFFFFFFFFFFF
FFFDDSSWWCCCRCCCCDDFFFFFFFFFFFFFFFFFFFFFFFFFFFFFFF
FFFFDSSWWCCCCRCCCDDFFFFFFFFFFFFFFFFFFFFFFFFFFFFFFF
FFFFDSSSWWWCCCRCCCDDDFFFFFFFFFFFFFFFFFFFFFFFFFFFFF
FFFFFDSSSWWCCRRRRRRDDDDDFFFFFFFFFFFFFFFFFFFFFFFFFF
FFFFFDDDSSWWRWWWWWWRDDDDDFFFFFFFFFFFFFFFFFFFFFFFFF
FFFFFFDDSSSWRWWWWWWWRDDDDDFFFFFFFFFFFFFFFFFFFFFFFF
FFFFFFFFDDSSRWWWWWWWWRDDDDDFFFFFFFFFFFFFFFFFFFFFFF
FFFFFFFFFDDDDRRRRWWWWWRDDDDDFFFFFFFFFFFFFFFFFFFFFF
FFFFFFFFFFDDDDDDDRWWWWWRDDDDDFFFFFFFFFFFFFFFFFFFFF
FBBBBBBBBBBDDDDDDDRWWWWRDDDDDDDDFFFFFFFFFFFFFFFFFF
FBBBBBBBBBBDDDDDDDRWWWWRDDDDDDDDDFFFFFFFFFFFFFFFFF
FBBBBBBBBBBDDDDDDDRWWFWWRRRDDDFFDDFFFFFFFFFFFFFFFF
FBBBBBBBBBBDDDDDDDRWWFWWRCCRRDDFFDDFFFFFFFFFFFFFFF
FBBBBBBBBBBDDDDDDDRWWDWWRCCCLRDFFFDDFFFFFFFFFFFFFF
FFBBBBBBBBBDDDDDDDRDWWWRCCCCCCRDFFFDDDFFFFFFFFFFFF
FFFBBBBBBBFDDDDDDDDRWWWRCCCCCCCRDFFFDDDFFFFFFFFFFF
FFFFFBBBBDDDDDDDDDDRWWWRCCCCCCCLRDFFFDDDFFFFFFFFFF
FFFFFDDDDDDDDDDDDDRRRRRRCCCCCCCCRDFFFFFDDDFFFFFFFF
FFFFDDBBBBBBBBDDDRRRCWWRCCCCCCCRDDDFFFFFDDDFFFFFFF
FFFDDBBBBBBBBBDDDRCRCCWWRCCCCCLRDDDDFFFFFFDDDFFFDF
FFFDBBBBBBBBBBDDRCCCRCWWRCCCCCRRDDDDDFFFFFFFDDDDDD
FFFDBBBBBBBBBBDDRCCCCRWRWRCCCRWWRLDDDDFFFFFFFDDRRR
FFFDBBBBBBBBBBDDRCCCCCRWWRCCRWWWWRDDDDDFFFFFDDRWWW
FFFDBBBBBBBBBBDDRCCCCCCRWWRRWWWWWWRLDDDDFFFDDRWWWW
FFDDBBBBBBBBBBDDRCCCCCCCRWWWWCCWWWWRDDDDDDDDRWWWWW
FFDDBBBBBBBBBDDDRCCCCCCCRCWWCCCCCWWWLRDDDDDRWWWWWS
FFDDBBBBBBBBDDDDRRCCCCCCRCCCCCCCCCCWRWRRRRRWWWWSSS
FFFDBBBBDDDDDDRRRRRCCCCCRCCCCCCCCCCCRWWWWWWWWSSSSS
FFFDDDDDDRRRRRRDDLRRRCCRRRRRRRRRCCCCRWWWWWWWSSDDDD
FDDDDDRRRRRRDDDDDDDDLRRDDDLDDDDLRRRRRRWWWDDDDDDDDD
DDDRRRRRRDDDDDBBBBBBDDDDDDBBBDDDDDDDLDRWWDDDDDDDDF
RRRRRRDDDDDDDBBBBBBBBBBBBBBBBBDDFFFFDDDRWWDDDDDFFF
RRRDDDDFFFDDBBBBBBBBBBBBBBBBBBBDDFFFFDDRWWDDDDDDDF
DDDDDFFFFFFDBBBBBBBBBBBBBBBBBBBBDDFFFFDRWWWDDRRDDD
FFFFFFFFFFFBBBBBBBBBBBBBBBBBBBBBBDDDFFDRWWRRRCDRRD
FFFFFFFFFFFBBBBBBBBBBBBBBBBBBBBBBBBDDDDRRRWWCCDDRR
FFFFFFFFFFFBBBBBBBBBBBBBBBBBBBBBBBBBBDDRCCWWCCCDDD
FFFFFFFFFFFBBBBBBBBBBBBBBBBBBBBBBBBBBBBRCCCWWCCDDD
FFFFFFFFFFFBBBBBBBBBBBBBBBBBBBBBBBBBBBBRCCCWWCCCCD
